SampleID	nEvalVariants	novelSites	nVariantsAtComp	nInsertions	nDeletions	InsDelRatio	nSingletons	nHets	nHomRef	nHomVar	HetHomeRatio	nTi	nTv	TiTvRatio
Sample-001	3849129	349460	3499669	179803	211408	0.85	12897	2423976	34593271	1425153	1.7	1961937	1047296	1.87
Sample-002	3815534	334143	3481391	178521	210833	0.85	13763	2440755	34621095	1374779	1.78	1962590	1044838	1.88
Sample-003	4471107	415767	4055340	204906	249536	0.82	50084	3052977	33959285	1418130	2.15	2334836	1232177	1.89
Sample-004	4322699	393749	3928950	198618	240438	0.83	45329	2894440	34101318	1428259	2.03	2250662	1188404	1.89
Sample-005	3845876	343293	3502583	179544	209947	0.86	13121	2422755	34595799	1423121	1.7	1967284	1050950	1.87
Sample-006	3822538	336991	3485547	178618	211542	0.84	14816	2427692	34622357	1394846	1.74	1960315	1044733	1.88
Sample-007	3790689	334898	3455791	177930	206486	0.86	13229	2373956	34640120	1416733	1.68	1944108	1035546	1.88
Sample-008	3835222	345614	3489608	179600	210753	0.85	12854	2411804	34612691	1423418	1.69	1959828	1045843	1.87
Sample-009	3875078	355542	3519536	181325	212496	0.85	15414	2485966	34573880	1389112	1.79	1974180	1056028	1.87
Sample-010	3898966	370695	3528271	183038	215392	0.85	22611	2480728	34544288	1418238	1.75	1978199	1057880	1.87
Sample-011	4613935	426688	4187247	209740	258874	0.81	62316	3216318	33801393	1397617	2.3	2409832	1270060	1.9
Sample-012	3851371	352912	3498459	180549	211596	0.85	14580	2446619	34583541	1404752	1.74	1963276	1048992	1.87
Sample-013	3940047	375630	3564417	184620	212513	0.87	20005	2555434	34528199	1384613	1.85	1998513	1070450	1.87
Sample-014	3780544	323393	3457151	176618	208272	0.85	12160	2361997	34630743	1418547	1.67	1950279	1034730	1.88
Sample-015	3863274	352724	3510550	181084	211059	0.86	14135	2430226	34579257	1433048	1.7	1976935	1054927	1.87
Sample-016	3847662	350354	3497308	179722	212484	0.85	19554	2443632	34590528	1404030	1.74	1984102	1054375	1.88
Sample-017	3817885	342665	3475220	178715	209146	0.85	13520	2410701	34619652	1407184	1.71	1957148	1042159	1.88
Sample-018	3771249	319449	3451800	175831	207488	0.85	13157	2340024	34607059	1431225	1.63	1950756	1035143	1.88
Sample-019	3850656	343649	3507007	180218	212984	0.85	14746	2465138	34593163	1385518	1.78	1976448	1051834	1.88
Sample-020	3818501	341545	3476956	178918	210377	0.85	12682	2378363	34619036	1440138	1.65	1947230	1041402	1.87
Sample-021	3800904	328629	3472275	177845	208106	0.85	13129	2381813	34609828	1419091	1.68	1965200	1044159	1.88
Sample-022	3909806	358222	3551584	182793	213385	0.86	18633	2532302	34538324	1377504	1.84	1997095	1066737	1.87
Sample-023	3900507	352935	3547572	182071	214429	0.85	23102	2532397	34540510	1368110	1.85	2004766	1066998	1.88
Sample-024	3835486	351604	3483882	179290	211765	0.85	10041	2408380	34606106	1427106	1.69	1954202	1045140	1.87
Sample-025	3822385	328243	3494142	178716	210743	0.85	16863	2456302	34606036	1366083	1.8	1973227	1047971	1.88
Sample-026	3862959	353738	3509221	180205	215755	0.84	14083	2451366	34584888	1411593	1.74	1986902	1058983	1.88
Sample-027	3868157	351469	3516688	181332	212176	0.85	17701	2456376	34584870	1411781	1.74	1977726	1056133	1.87
Sample-028	4547183	442693	4104490	208722	255678	0.82	51852	3119369	33900266	1427814	2.18	2359122	1248986	1.89
Sample-029	3927994	363809	3564185	183983	215983	0.85	20383	2541853	34514806	1386141	1.83	2000521	1066947	1.87
Sample-030	3870432	354588	3515844	181636	213755	0.85	14721	2495582	34579684	1374850	1.82	1974028	1053880	1.87
Sample-031	3867189	343697	3523492	180900	215040	0.84	20707	2507495	34550335	1359694	1.84	1992510	1058629	1.88
Sample-032	3861086	351650	3509436	181035	211648	0.86	13198	2435674	34582581	1425412	1.71	1962069	1050771	1.87
Sample-033	3843266	352943	3490323	179950	212619	0.85	13207	2429176	34589810	1414090	1.72	1956350	1043962	1.87
Sample-034	4500741	422750	4077991	205601	250453	0.82	46503	3164060	33944405	1336681	2.37	2335288	1236940	1.89
Sample-035	3837481	351666	3485815	179414	210516	0.85	13856	2404185	34603917	1433296	1.68	1958217	1045670	1.87
Sample-036	3799149	344896	3454253	178187	208975	0.85	13342	2395331	34633307	1403818	1.71	1937984	1034990	1.87
Sample-037	3848223	356440	3491783	180530	211922	0.85	14010	2425771	34602950	1422452	1.71	1956346	1048368	1.87
Sample-038	3846519	350355	3496164	180212	211944	0.85	14080	2449582	34599024	1396937	1.75	1963093	1046439	1.88
Sample-039	3861980	348459	3513521	180758	209165	0.86	14625	2475763	34585239	1386217	1.79	1979816	1057179	1.87
Sample-040	3874972	345658	3529314	181109	212175	0.85	15631	2498508	34556274	1376464	1.82	1989681	1059908	1.88
Sample-041	3873456	352787	3520669	181654	210968	0.86	15618	2480425	34583421	1393031	1.78	1981151	1057420	1.87
Sample-042	3888157	354845	3533312	181691	214276	0.85	13941	2518219	34559215	1369938	1.84	1981309	1058231	1.87
Sample-043	3883355	356603	3526752	181287	211577	0.86	13955	2505118	34570393	1378237	1.82	1977413	1058490	1.87
Sample-044	4455470	399850	4055620	203478	247067	0.82	47398	3024343	33957945	1431127	2.11	2339350	1231114	1.9
Sample-045	3832181	347250	3484931	178675	211157	0.85	17001	2419007	34603792	1413174	1.71	1960808	1045988	1.87
Sample-046	3895322	359721	3535601	182293	212971	0.86	13730	2504640	34553129	1390682	1.8	1975311	1057896	1.87
Sample-047	3857618	351294	3506324	181359	210675	0.86	12838	2434003	34591786	1423615	1.71	1959843	1048336	1.87
Sample-048	3828674	338998	3489676	178463	210521	0.85	15277	2456734	34616757	1371940	1.79	1975484	1050746	1.88
Sample-049	3846287	345867	3500420	180005	211611	0.85	14161	2434717	34592501	1411570	1.72	1966162	1049829	1.87
Sample-050	3891276	347437	3543839	181765	214687	0.85	15903	2516367	34547815	1374909	1.83	1993479	1062118	1.88
Sample-051	4674211	448826	4225385	213407	263831	0.81	66797	3225718	33757337	1448493	2.23	2439343	1285295	1.9
Sample-052	3863227	348320	3514907	180999	211262	0.86	14504	2478547	34579520	1384680	1.79	1980522	1056101	1.88
Sample-053	3871965	363825	3508140	181655	214444	0.85	21544	2439733	34567251	1432232	1.7	1976447	1053826	1.88
Sample-054	3903650	365731	3537919	181623	213334	0.85	28673	2534314	34541889	1369336	1.85	1994691	1064545	1.87
Sample-055	3862339	353600	3508739	180993	211961	0.85	12499	2451620	34581461	1410719	1.74	1970024	1053766	1.87
Sample-056	3843817	360688	3483129	179629	211097	0.85	30335	2290471	34587728	1553346	1.47	1961185	1050788	1.87
Sample-057	3828884	337395	3491489	178233	210943	0.84	13009	2417391	34595871	1411493	1.71	1963666	1045804	1.88
Sample-058	3837632	351724	3485908	179495	209234	0.86	13488	2414266	34610207	1423366	1.7	1965113	1048957	1.87
Sample-059	3835431	346925	3488506	179494	208722	0.86	12954	2416587	34610086	1418844	1.7	1969837	1049426	1.88
Sample-060	3837924	352684	3485240	179212	211507	0.85	13638	2411070	34602184	1426854	1.69	1953904	1044640	1.87
Sample-061	3858378	338304	3520074	180400	213296	0.85	13834	2487664	34585376	1370714	1.81	1985677	1056819	1.88
Sample-062	3803502	329614	3473888	177274	208969	0.85	13142	2377979	34609202	1425523	1.67	1961171	1045227	1.88
Sample-063	3835341	349561	3485780	179487	211950	0.85	13638	2409545	34605394	1425796	1.69	1958627	1046254	1.87
Sample-064	3932983	372161	3560822	183398	214808	0.85	27411	2551864	34514154	1381119	1.85	2004397	1071137	1.87
Sample-065	3890896	356992	3533904	181786	213415	0.85	14279	2498202	34561714	1392694	1.79	1979764	1058427	1.87
Sample-066	3883921	353725	3530196	182151	212850	0.86	12987	2501386	34563727	1382535	1.81	1979399	1056548	1.87
Sample-067	3833670	353396	3480274	179439	212772	0.84	13387	2414231	34608370	1419439	1.7	1950726	1044005	1.87
Sample-068	4669059	452345	4216714	212530	262841	0.81	62788	3237805	33772347	1431254	2.26	2422176	1281170	1.89
Sample-069	4606455	444026	4162429	211414	252431	0.84	63478	3145096	33693752	1461359	2.15	2402905	1266371	1.9
Sample-070	3729817	313122	3416695	176039	194529	0.9	13167	2285394	34526265	1444423	1.58	1945742	1026851	1.89
Sample-071	3752015	314806	3437209	177288	195601	0.91	13324	2312191	34532843	1439824	1.61	1951847	1032574	1.89
Sample-072	3837864	346829	3491035	183456	203255	0.9	13145	2390590	34456559	1447274	1.65	1962264	1046221	1.88
Sample-073	3844362	351815	3492547	182855	203524	0.9	14675	2404664	34467681	1439698	1.67	1970167	1051411	1.87
Sample-074	3779904	313353	3466551	179009	196127	0.91	14750	2382301	34490119	1397603	1.7	1971322	1039769	1.9
Sample-075	3872545	361356	3511189	184086	205105	0.9	24852	2429921	34419311	1442624	1.68	1988746	1059254	1.88
Sample-076	3860182	348281	3511901	183986	204785	0.9	15862	2460992	34423559	1399190	1.76	1975751	1051759	1.88
Sample-077	4583154	431123	4152031	212452	246193	0.86	58792	3177525	33717491	1405629	2.26	2391141	1257666	1.9
Sample-078	4545007	430046	4114961	210437	246895	0.85	53667	3069515	33731559	1475492	2.08	2372954	1249365	1.9
Sample-079	3896030	352618	3543412	185840	206395	0.9	14471	2499312	34402022	1396718	1.79	1993951	1061916	1.88
Sample-080	3826738	339901	3486837	181609	202097	0.9	13488	2395652	34456732	1431086	1.67	1968580	1046236	1.88
Sample-081	3765911	323280	3442631	178323	196961	0.91	14024	2330875	34507881	1435036	1.62	1954338	1034882	1.89
Sample-082	3833771	336822	3496949	181882	200821	0.91	13327	2410165	34446844	1423606	1.69	1977672	1050001	1.88
Sample-083	3862106	352952	3509154	184040	204739	0.9	13446	2410317	34447696	1451789	1.66	1977386	1053762	1.88
Sample-084	3858552	340394	3518158	183387	202679	0.9	14686	2452722	34434342	1405830	1.74	1983741	1053411	1.88
Sample-085	3824916	329782	3495134	180105	200297	0.9	14641	2415718	34455651	1409198	1.71	1985677	1050439	1.89
Sample-086	3875448	366280	3509168	184523	205217	0.9	25338	2440477	34423843	1434971	1.7	1985153	1056180	1.88
Sample-087	3898022	368592	3529430	185258	207093	0.89	26689	2450394	34399507	1447628	1.69	1996154	1064807	1.87
Sample-088	3877885	354841	3523044	184515	206055	0.9	14733	2472711	34433692	1405174	1.76	1984942	1057730	1.88
Sample-089	3829793	343294	3486499	183901	201119	0.91	13375	2385824	34474528	1443969	1.65	1960459	1042158	1.88
Sample-090	3817490	342046	3475444	180935	201403	0.9	13694	2381758	34480885	1435732	1.66	1965754	1045753	1.88
Sample-091	3843079	351934	3491145	182845	203137	0.9	13562	2412752	34474990	1430327	1.69	1971323	1049767	1.88
Sample-092	3827570	373173	3454397	176207	208649	0.84	15628	2403450	34468474	1424120	1.69	1975512	1056832	1.87
Sample-093	3794291	335225	3459066	181114	194431	0.93	13372	2351120	34504908	1443171	1.63	1970564	1043409	1.89
Sample-094	3795571	328316	3467255	179568	198930	0.9	14704	2385172	34461895	1410399	1.69	1966466	1040344	1.89
Sample-095	3784903	330646	3454257	179810	199486	0.9	14499	2350396	34502133	1434507	1.64	1954355	1037359	1.88
Sample-096	3832101	331665	3500436	181007	202498	0.89	15713	2442409	34450453	1389692	1.76	1985615	1050684	1.89
Sample-097	3761007	311286	3449721	176776	196830	0.9	13890	2330147	34480806	1430860	1.63	1960347	1035248	1.89
Sample-098	3863536	375029	3488507	184507	207361	0.89	11980	2425450	34494280	1438086	1.69	1958961	1051090	1.86
Sample-099	3792187	331825	3460362	179529	198770	0.9	19101	2365508	34481595	1426679	1.66	1966589	1041618	1.89
Sample-100	3843227	348513	3494714	183091	203121	0.9	13259	2415023	34467135	1428204	1.69	1966240	1049157	1.87
Sample-101	4576476	432327	4144149	211343	247725	0.85	55996	3094439	33704457	1482037	2.09	2380681	1255266	1.9
Sample-102	3785734	328800	3456934	180079	199789	0.9	13415	2344610	34492460	1441124	1.63	1949668	1035247	1.88
Sample-103	3826102	331724	3494378	181674	200883	0.9	14412	2379764	34447185	1446338	1.65	1974019	1045996	1.89
Sample-104	3789019	325322	3463697	179859	199354	0.9	14551	2350293	34472735	1438726	1.63	1958335	1038089	1.89
Sample-105	3854197	346575	3507622	183970	203943	0.9	14786	2440938	34467273	1413259	1.73	1973857	1050380	1.88
Sample-106	3796746	318094	3478652	180076	198393	0.91	14389	2353662	34457738	1443084	1.63	1966622	1040402	1.89
Sample-107	3839580	336252	3503328	181174	202774	0.89	15089	2436264	34457473	1403316	1.74	1982672	1052631	1.88
Sample-108	3777777	330217	3447560	179215	200002	0.9	14853	2342710	34501277	1435067	1.63	1947481	1032815	1.89
Sample-109	4542299	431256	4111043	210417	246534	0.85	52564	3085011	33742987	1457288	2.12	2356607	1243612	1.89
Sample-110	4282438	374407	3908031	198414	226328	0.88	35704	2968068	33981339	1314370	2.26	2248078	1182017	1.9
Sample-111	3756626	317956	3438670	177101	197001	0.9	14379	2323461	34478073	1433165	1.62	1955877	1034024	1.89
Sample-112	3806954	339875	3467079	180901	200499	0.9	13888	2371311	34482440	1435643	1.65	1958358	1041329	1.88
Sample-113	3800792	336910	3463882	179178	201646	0.89	13492	2377907	34447685	1422885	1.67	1968919	1045154	1.88
Sample-114	3829274	342714	3486560	180496	203040	0.89	13027	2394154	34447208	1435120	1.67	1968066	1047002	1.88
Sample-115	4509578	414369	4095209	207364	244504	0.85	50965	3167826	33747014	1341752	2.36	2361248	1240038	1.9
Sample-116	3835898	340389	3495509	180446	202015	0.89	14411	2435871	34422318	1400027	1.74	1984669	1052940	1.88
Sample-117	3807714	327993	3479721	180052	199660	0.9	15143	2395501	34465731	1412213	1.7	1974463	1045711	1.89
Sample-118	3777490	334732	3442758	177856	199987	0.89	11781	2335766	34477654	1441724	1.62	1953058	1036915	1.88
Sample-119	3780808	317888	3462920	179155	195702	0.92	13474	2336670	34482676	1444138	1.62	1964110	1039521	1.89
Sample-120	4603176	436154	4167022	211805	251170	0.84	56902	3204309	33664516	1398867	2.29	2397017	1262210	1.9
Sample-121	3874695	348908	3525787	182955	206533	0.89	15657	2482694	34396886	1392001	1.78	1998567	1062550	1.88
Sample-122	4573782	433856	4139926	209369	249810	0.84	57704	3076876	33675936	1496906	2.06	2386999	1258260	1.9
Sample-123	3833557	345086	3488471	182121	203246	0.9	13124	2394004	34465044	1439553	1.66	1967522	1047098	1.88
Sample-124	3746518	320124	3426394	176493	192960	0.91	12955	2303415	34489367	1443103	1.6	1952883	1034396	1.89
Sample-125	3819101	341828	3477273	181980	200943	0.91	11549	2375312	34464271	1443789	1.65	1959566	1042221	1.88
Sample-126	3790944	332406	3458538	180317	199298	0.9	13512	2359802	34477289	1431142	1.65	1949901	1036436	1.88
Sample-127	4311628	381957	3929671	198820	231344	0.86	40067	2954691	33926834	1356937	2.18	2262048	1189735	1.9
Sample-128	3858457	344368	3514089	183294	203520	0.9	15373	2464654	34391876	1393803	1.77	1986538	1052474	1.89
Sample-129	3817494	344674	3472820	181929	202308	0.9	13729	2373415	34472540	1444079	1.64	1960210	1042217	1.88
Sample-130	4543318	421407	4121911	207573	248337	0.84	54935	3053246	33679964	1490072	2.05	2377263	1251097	1.9
Sample-131	3811054	341775	3469279	179835	201386	0.89	17947	2375756	34452661	1435298	1.66	1970340	1045209	1.89
Sample-132	3875426	337733	3537693	183059	203075	0.9	22288	2460767	34402839	1414659	1.74	2006161	1063675	1.89
Sample-133	3797048	344388	3452660	179694	202283	0.89	13812	2369338	34484196	1427710	1.66	1948120	1036101	1.88
Sample-134	4630679	433892	4196787	211941	251524	0.84	63212	3205250	33626520	1425429	2.25	2428057	1275229	1.9
Sample-135	3823576	335447	3488129	181347	201109	0.9	13481	2377468	34438756	1446108	1.64	1969728	1046062	1.88
Sample-136	4590097	432270	4157827	210846	248277	0.85	62139	3061805	33677495	1528292	2	2409143	1264279	1.91
Sample-137	3819120	340643	3478477	181225	201658	0.9	14921	2414170	34478340	1404950	1.72	1963448	1043434	1.88
Sample-138	3811468	332997	3478471	180782	199991	0.9	13689	2380684	34467001	1430784	1.66	1967123	1043875	1.88
Sample-139	3804831	332826	3472005	180180	199497	0.9	13694	2368042	34465430	1436789	1.65	1964603	1042969	1.88
Sample-140	3801251	328234	3473017	179714	199411	0.9	11149	2351242	34468390	1450009	1.62	1964360	1040293	1.89
Sample-141	3799246	328450	3470796	180020	198835	0.91	13833	2338697	34481528	1460549	1.6	1957921	1040291	1.88
Sample-142	3847265	352758	3494507	183274	204729	0.9	14237	2397439	34426492	1449826	1.65	1964258	1047597	1.88
Sample-143	3809688	327201	3482487	181770	199867	0.91	16056	2425504	34483120	1384184	1.75	1971668	1044901	1.89
Sample-144	3814623	328030	3486593	180247	200345	0.9	14110	2411477	34479827	1403146	1.72	1976902	1045608	1.89
Sample-145	3841050	341192	3499858	180719	204696	0.88	65271	2272058	34399597	1568992	1.45	1985767	1053940	1.88
Sample-146	3821298	344175	3477123	181220	204193	0.89	14364	2404667	34439396	1416631	1.7	1958922	1042624	1.88
Sample-147	3834770	333962	3500808	181713	200338	0.91	17054	2395940	34437872	1438830	1.67	1985152	1051594	1.89
Sample-148	3878039	349010	3529029	184704	205404	0.9	15305	2479784	34421086	1398255	1.77	1988782	1057604	1.88
Sample-149	4493747	425782	4067965	206711	245393	0.84	48719	3038960	33765379	1454787	2.09	2341702	1234223	1.9
Sample-150	3832309	347563	3484746	181682	204044	0.89	14258	2392539	34433828	1439770	1.66	1966727	1046321	1.88
Sample-151	4585488	436429	4149059	210770	250291	0.84	58075	3075645	33661845	1509843	2.04	2387594	1257412	1.9
Sample-152	4633949	435290	4198659	212575	252672	0.84	63046	3229784	33650633	1404165	2.3	2428332	1276232	1.9
Sample-153	3820377	340916	3479461	181200	202749	0.89	14011	2384036	34432528	1436341	1.66	1968133	1044821	1.88
Sample-154	3800213	336944	3463269	180391	200422	0.9	13329	2354637	34479856	1445576	1.63	1954861	1039812	1.88
Sample-155	3817715	346747	3470968	181464	202342	0.9	13814	2388940	34473633	1428775	1.67	1955420	1040756	1.88
Sample-156	3782843	328250	3454593	181412	196920	0.92	12636	2352466	34512362	1430377	1.64	1942121	1030997	1.88
Sample-157	3876740	361298	3515442	185762	206479	0.9	64709	2295574	34426300	1581166	1.45	1968019	1052399	1.87
Sample-158	3851201	353165	3498036	185075	201314	0.92	14017	2426422	34468075	1424779	1.7	1955068	1042434	1.88
Sample-159	4128134	384556	3743578	194934	219833	0.89	25464	2781256	34192997	1346878	2.06	2115669	1125465	1.88
Sample-160	3875040	359788	3515252	184918	204422	0.9	16227	2450374	34433441	1424666	1.72	1969190	1050349	1.87
Sample-161	3917864	367419	3550445	186901	208959	0.89	13903	2516796	34410778	1401068	1.8	1991263	1063806	1.87
Sample-162	3860537	357312	3503225	185565	202873	0.91	13210	2425194	34450599	1435343	1.69	1956328	1042499	1.88
Sample-163	3879292	364761	3514531	185283	207113	0.89	13982	2446760	34452241	1432532	1.71	1967362	1053731	1.87
Sample-164	3792546	331241	3461305	179620	201471	0.89	12879	2358043	34471361	1434503	1.64	1949033	1035913	1.88
Sample-165	3768469	324081	3444388	178279	200142	0.89	15420	2334360	34447987	1434109	1.63	1954575	1029627	1.9
Sample-166	3732229	313508	3418721	175959	196090	0.9	14166	2288265	34511095	1443964	1.58	1959170	1031071	1.9
Sample-167	4421529	396093	4025436	202637	237725	0.85	50768	2963235	33807470	1458294	2.03	2341600	1225114	1.91
Sample-168	3728462	308625	3419837	176168	195843	0.9	13008	2284336	34499584	1444126	1.58	1947650	1027216	1.9
Sample-169	4533445	421882	4111563	207689	247924	0.84	55683	3129359	33727804	1404086	2.23	2377323	1251789	1.9
Sample-170	3881882	337247	3544635	183351	205645	0.89	17789	2492612	34349364	1389270	1.79	2019632	1066582	1.89
Sample-171	3807525	334454	3473071	180312	201511	0.89	14783	2365161	34440296	1442364	1.64	1970025	1043520	1.89
Sample-172	4555535	425901	4129634	208708	247240	0.84	58977	3047662	33683865	1507873	2.02	2394088	1258140	1.9
Sample-173	3690455	304898	3385557	173506	193042	0.9	13828	2257405	34539973	1433050	1.58	1945507	1021466	1.9
Sample-174	3800647	324636	3476011	178467	199942	0.89	30581	2319734	34409688	1480913	1.57	1986172	1046259	1.9
Sample-175	3839228	351781	3487447	182052	203960	0.89	23002	2395447	34442306	1443781	1.66	1981971	1051157	1.89
Sample-176	3788169	315956	3472213	179701	198798	0.9	14789	2384322	34474342	1403847	1.7	1977319	1041851	1.9
Sample-177	3673558	280274	3393284	172057	189242	0.91	13704	2256650	34528050	1416908	1.59	1956676	1021003	1.92
Sample-178	3777305	325408	3451897	179702	199926	0.9	12730	2340514	34473270	1436791	1.63	1950901	1034063	1.89
Sample-179	3774507	326561	3447946	178703	198871	0.9	13638	2325767	34460567	1448740	1.61	1952849	1032652	1.89
Sample-180	3827678	330344	3497334	181700	202773	0.9	16702	2444620	34415978	1383058	1.77	1979172	1046204	1.89
Sample-181	3753679	308304	3445375	176635	197234	0.9	14250	2348221	34473428	1405458	1.67	1970497	1036626	1.9
Sample-182	3772048	327942	3444106	179002	199415	0.9	14282	2322596	34475746	1449452	1.6	1946874	1029435	1.89
Sample-183	3779193	318446	3460747	177614	200543	0.89	15610	2397494	34476065	1381699	1.74	1983699	1043576	1.9
Sample-184	3757351	315217	3442134	178255	198318	0.9	14086	2314097	34490521	1443254	1.6	1951118	1031626	1.89
Sample-185	4327425	361060	3966365	196760	230808	0.85	53812	2946315	33863509	1381110	2.13	2324193	1207690	1.92
Sample-186	3772399	315828	3456571	177803	198780	0.89	14918	2363879	34477354	1408520	1.68	1969582	1037929	1.9
Sample-187	3805679	331392	3474287	181002	202275	0.89	13999	2368158	34452389	1437521	1.65	1955141	1038878	1.88
Sample-188	3806544	320949	3485595	179176	202154	0.89	23098	2392132	34440396	1414412	1.69	1988254	1046815	1.9
Sample-189	3781612	325411	3456201	180070	200433	0.9	13549	2345676	34485806	1435936	1.63	1950631	1032985	1.89
Sample-190	3787806	330864	3456942	179896	199511	0.9	15572	2348297	34461041	1439509	1.63	1959570	1036119	1.89
Sample-191	3732417	312316	3420101	175103	196728	0.89	14065	2301236	34502153	1431181	1.61	1949827	1027046	1.9
Sample-192	3808329	336545	3471784	181034	202240	0.9	14432	2367502	34476521	1440827	1.64	1965057	1042473	1.88
Sample-193	4029672	347100	3682572	189333	214616	0.88	36013	2679648	34224558	1350024	1.98	2089918	1101978	1.9
Sample-194	3795562	333842	3461720	179926	201617	0.89	13075	2344718	34440148	1450844	1.62	1961180	1040303	1.89
Sample-195	3779114	331707	3447407	177937	200910	0.89	13481	2359488	34437342	1419626	1.66	1957738	1036376	1.89
Sample-196	3789394	325654	3463740	180054	199749	0.9	12650	2352688	34462279	1436706	1.64	1951693	1034970	1.89
Sample-197	3822941	338988	3483953	181076	202967	0.89	14685	2422864	34423143	1400077	1.73	1971982	1044531	1.89
Sample-198	3874138	347089	3527049	183339	206959	0.89	29404	2390515	34388370	1483623	1.61	1994555	1059961	1.88
Sample-199	3832006	336004	3496002	181573	203291	0.89	14707	2425797	34444319	1406209	1.73	1979239	1050844	1.88
Sample-200	3804107	348343	3455764	179823	205016	0.88	14122	2353051	34478704	1451056	1.62	1953162	1041806	1.87
Sample-201	3800928	332400	3468528	180384	200499	0.9	14541	2357257	34454232	1443671	1.63	1962775	1039737	1.89
Sample-202	3801033	330579	3470454	180748	200963	0.9	13139	2346645	34464691	1454388	1.61	1957888	1037582	1.89
Sample-203	3752336	319631	3432705	176911	198243	0.89	14854	2323242	34491310	1429094	1.63	1959139	1033628	1.9
Sample-204	3826081	330128	3495953	181078	203855	0.89	15065	2425120	34406458	1400961	1.73	1975488	1043986	1.89
Sample-205	3810675	342452	3468223	181637	202767	0.9	14135	2378575	34459128	1432100	1.66	1955404	1040310	1.88
Sample-206	3760437	321088	3439349	176282	198746	0.89	13209	2317823	34463447	1442614	1.61	1966770	1039150	1.89
Sample-207	3760040	324578	3435462	178335	198308	0.9	12788	2336464	34470376	1423576	1.64	1939494	1026895	1.89
Sample-208	3719340	306213	3413127	175947	195211	0.9	12985	2275977	34514362	1443363	1.58	1943343	1023848	1.9
Sample-209	3800982	318105	3482877	178466	198221	0.9	27568	2404979	34415967	1396003	1.72	2002441	1049891	1.91
Sample-210	3788172	309697	3478475	178130	196178	0.91	18610	2390994	34442802	1397178	1.71	1986979	1044696	1.9
Sample-211	3735154	296927	3438227	176035	196773	0.89	13921	2316378	34490200	1418776	1.63	1953825	1028676	1.9
Sample-212	3701507	303128	3398379	174425	195281	0.89	13085	2271964	34478975	1429543	1.59	1944050	1020737	1.9
Sample-213	3751473	323922	3427551	177265	198971	0.89	13181	2313946	34494860	1437527	1.61	1947655	1031030	1.89
Sample-214	4577187	418049	4159138	208744	248595	0.84	63709	3083410	33658907	1493777	2.06	2420106	1266879	1.91
Sample-215	3759956	321770	3438186	177213	198027	0.89	13632	2338290	34477866	1421666	1.64	1960790	1035891	1.89
Sample-216	4527077	414784	4112293	206819	245429	0.84	55249	3130977	33736036	1396100	2.24	2384780	1250711	1.91
Sample-217	3855396	351547	3503849	182711	207100	0.88	14622	2444990	34453810	1410406	1.73	1979317	1054117	1.88
Sample-218	3791338	329978	3461360	177891	201893	0.88	14980	2381693	34474691	1409645	1.69	1973438	1044114	1.89
Sample-219	3689921	286637	3403284	173416	190678	0.91	12736	2254879	34514788	1435042	1.57	1953720	1023981	1.91
Sample-220	3750577	327262	3423315	177861	199318	0.89	13376	2309247	34509584	1441330	1.6	1943340	1029309	1.89
Sample-221	3820406	323801	3496605	179975	201248	0.89	14969	2395919	34420001	1424487	1.68	1985390	1050164	1.89
Sample-222	3765738	318910	3446828	178553	197156	0.91	13211	2319734	34462509	1446004	1.6	1956642	1033624	1.89
Sample-223	4118267	355888	3762379	193766	219197	0.88	28651	2760488	34104218	1357779	2.03	2147779	1127324	1.91
Sample-224	3745211	315430	3429781	177444	197699	0.9	13532	2309197	34498695	1436014	1.61	1949230	1028806	1.89
Sample-225	3794394	338211	3456183	179890	202818	0.89	13439	2343175	34461020	1451219	1.61	1953798	1037428	1.88
Sample-226	3737755	316671	3421084	176706	197081	0.9	14013	2293203	34495581	1444552	1.59	1951450	1029532	1.9
Sample-227	3736534	300992	3435542	178310	194306	0.92	14420	2300219	34493944	1436315	1.6	1939683	1022384	1.9
Sample-228	3791531	323296	3468235	179152	199227	0.9	15303	2405373	34441587	1386158	1.74	1972395	1041092	1.89
Sample-229	4028346	364842	3663504	189894	217592	0.87	27675	2616195	34210345	1412151	1.85	2076637	1100257	1.89
Sample-230	3819195	344633	3474562	180630	202303	0.89	24708	2385635	34436896	1433560	1.66	1976873	1048517	1.89
Sample-231	3677340	282297	3395043	174692	189021	0.92	13871	2246056	34533695	1431284	1.57	1930863	1013350	1.91
Sample-232	3793428	338265	3455163	179703	203705	0.88	13397	2356829	34452596	1436599	1.64	1951373	1036450	1.88
Sample-233	3756689	316733	3439956	177074	198388	0.89	14002	2326356	34463183	1430333	1.63	1957020	1032047	1.9
Sample-234	3773298	328851	3444447	179412	199551	0.9	15480	2332662	34474204	1440636	1.62	1955496	1035800	1.89
Sample-235	3766556	327583	3438973	178327	198934	0.9	13411	2308498	34503058	1458058	1.58	1954618	1033945	1.89
Sample-236	3788774	305929	3482845	180219	198339	0.91	13811	2398948	34463063	1389826	1.73	1961488	1034478	1.9
Sample-237	3783155	332388	3450767	179710	199559	0.9	14239	2351112	34467138	1432043	1.64	1951560	1034131	1.89
Sample-238	3756011	321188	3434823	178809	197531	0.91	13426	2314322	34480441	1441689	1.61	1939032	1025013	1.89
Sample-239	3728370	302768	3425602	176098	195778	0.9	13911	2306907	34483984	1421463	1.62	1946176	1025356	1.9
Sample-240	3784470	309189	3475281	178730	197772	0.9	14847	2386800	34441193	1397670	1.71	1971834	1037760	1.9
Sample-241	3777474	325055	3452419	177487	198004	0.9	23620	2348663	34453746	1428811	1.64	1978415	1042842	1.9
Sample-242	3802702	334669	3468033	180394	201061	0.9	13835	2377710	34454982	1424992	1.67	1958077	1039546	1.88
Sample-243	3814613	321318	3493295	179806	200602	0.9	14387	2432225	34437875	1382388	1.76	1982477	1046868	1.89
Sample-244	3776558	313183	3463375	178478	197964	0.9	15542	2372819	34466073	1403739	1.69	1967040	1035540	1.9
Sample-245	3811645	328507	3483138	179973	200699	0.9	14483	2416125	34437151	1395520	1.73	1978832	1045132	1.89
Sample-246	3820863	339799	3481064	181685	203214	0.89	13340	2391026	34433441	1429837	1.67	1958190	1039044	1.88
Sample-247	3802578	322824	3479754	179394	199932	0.9	13652	2420734	34439938	1381844	1.75	1975686	1044497	1.89
Sample-248	4476268	387917	4088351	204166	240461	0.85	53266	3072311	33729943	1403957	2.19	2394437	1245387	1.92
Sample-249	3809082	328341	3480741	181087	200052	0.91	15062	2362783	34438582	1446299	1.63	1958460	1037625	1.89
Sample-250	3777815	320634	3457181	178293	198980	0.9	14542	2365639	34454358	1412176	1.68	1977941	1041705	1.9
Sample-251	3863036	356071	3506965	185177	206640	0.9	14689	2405953	34414796	1457083	1.65	1956336	1044598	1.87
Sample-252	3775249	325172	3450077	180457	198290	0.91	13542	2333011	34476484	1442238	1.62	1946968	1031533	1.89
Sample-253	3841988	337314	3504674	182384	203196	0.9	14373	2429760	34430760	1412228	1.72	1972720	1047144	1.88
Sample-254	3810651	311657	3498994	179912	198602	0.91	14357	2404819	34451615	1405832	1.71	1971412	1042246	1.89
Sample-255	3832441	325486	3506955	181043	201145	0.9	18813	2439355	34444885	1393086	1.75	1993904	1054577	1.89
Sample-256	3801489	333956	3467533	181379	200453	0.9	14562	2356098	34471880	1445391	1.63	1950803	1035113	1.88
Sample-257	3806899	335881	3471018	180727	199633	0.91	19829	2373680	34436324	1433219	1.66	1968028	1039685	1.89
Sample-258	3828872	350759	3478113	182623	203262	0.9	13612	2387925	34404606	1440947	1.66	1943554	1036314	1.88
Sample-259	3809092	334339	3474753	181814	202389	0.9	13022	2363867	34475142	1445225	1.64	1950218	1035586	1.88
Sample-260	3661337	278812	3382525	170900	188100	0.91	14601	2251348	34511375	1409989	1.6	1942780	1015530	1.91
Sample-261	3764919	325408	3439511	178273	196501	0.91	14947	2367399	34328545	1397520	1.69	1952484	1027364	1.9
Sample-262	3809308	364728	3444580	183158	198071	0.92	21297	2417087	34189700	1392221	1.74	1928813	1027240	1.88
Sample-263	3777138	340105	3437033	180935	197910	0.91	12491	2338895	34331507	1438243	1.63	1928822	1023410	1.88
Sample-264	3704309	293530	3410779	175122	193402	0.91	14949	2320461	34509344	1383848	1.68	1950810	1022826	1.91
Sample-265	3832174	325318	3506856	182114	201828	0.9	15901	2413946	34402788	1418228	1.7	1978641	1046085	1.89
Sample-266	3738846	318836	3420010	176783	194742	0.91	15593	2294893	34437471	1443953	1.59	1945613	1024620	1.9
Sample-267	3719739	312472	3407267	175124	194503	0.9	14302	2297924	34438520	1421815	1.62	1941051	1021250	1.9
Sample-268	3790482	329428	3461054	180773	198203	0.91	14009	2366026	34455260	1424456	1.66	1948030	1031373	1.89
Sample-269	3850918	351325	3499593	183026	204377	0.9	15110	2460280	34384639	1390638	1.77	1960796	1042874	1.88
Sample-270	3841649	332913	3508736	183205	201928	0.91	16105	2442322	34429302	1399327	1.75	1974331	1046283	1.89
Sample-271	3746952	305926	3441026	177941	194667	0.91	14141	2304067	34467398	1442885	1.6	1950855	1025950	1.9
Sample-272	3835719	347479	3488240	182973	203965	0.9	13703	2403129	34444541	1432590	1.68	1949769	1037997	1.88
Sample-273	4516628	400899	4115729	207582	243357	0.85	56670	2997469	33717109	1519159	1.97	2373582	1243044	1.91
Sample-274	4527024	408082	4118942	208455	245191	0.85	57578	3029260	33699116	1497764	2.02	2370405	1244137	1.91
Sample-275	3782350	325018	3457332	180207	199467	0.9	13242	2343855	34481113	1438495	1.63	1949867	1032398	1.89
Sample-276	4519527	398481	4121046	207689	242860	0.86	61448	2990837	33683235	1528690	1.96	2394785	1249410	1.92
Sample-277	4100609	361430	3739179	193065	217833	0.89	26135	2746706	34141114	1353903	2.03	2126457	1120153	1.9
Sample-278	3788630	322898	3465732	179837	199020	0.9	14011	2374420	34428466	1414210	1.68	1957220	1034167	1.89
Sample-279	3845778	342193	3503585	184343	202663	0.91	14705	2404820	34432963	1440958	1.67	1966274	1045119	1.88
Sample-280	4579739	408247	4171492	210172	247259	0.85	61792	3138972	33643310	1440767	2.18	2418886	1262778	1.92
Sample-281	3748855	318960	3429895	177454	197389	0.9	13171	2320753	34462469	1428102	1.63	1952495	1027971	1.9
Sample-282	3749224	302899	3446325	175910	196081	0.9	14352	2349255	34477876	1399969	1.68	1971500	1033654	1.91
Sample-283	4500165	403643	4096522	206012	244460	0.84	62506	3008589	33714543	1491576	2.02	2383017	1246510	1.91
Sample-284	3720941	299056	3421885	176116	193450	0.91	13706	2283824	34518926	1437117	1.59	1957526	1028323	1.9
Sample-285	3870366	341663	3528703	184889	205241	0.9	13636	2476395	34413501	1393971	1.78	1973806	1049667	1.88
Sample-286	3836320	332311	3504009	183023	202259	0.9	13315	2447049	34441408	1389271	1.76	1959864	1041766	1.88
Sample-287	3823123	330789	3492334	182220	201378	0.9	14364	2417659	34461691	1405464	1.72	1963389	1042149	1.88
Sample-288	3788427	320511	3467916	180068	199501	0.9	15416	2349929	34467441	1438498	1.63	1954125	1033634	1.89
Sample-289	3795474	326317	3469157	178251	201322	0.89	15783	2386828	34458801	1408646	1.69	1982853	1046524	1.89
Sample-290	4512119	396273	4115846	206849	241709	0.86	54630	2998032	33724806	1514087	1.98	2381323	1245967	1.91
Sample-291	3709572	305912	3403660	174685	193320	0.9	12254	2289460	34527395	1420112	1.61	1948566	1024156	1.9
Sample-292	3760128	305814	3454314	178275	196551	0.91	13678	2353828	34500064	1406300	1.67	1954816	1031562	1.9
Sample-293	4293591	370466	3923125	198475	228904	0.87	43737	2873358	33945766	1420233	2.02	2273181	1190343	1.91
Sample-294	3819069	339204	3479865	182282	202226	0.9	12597	2368984	34451082	1450085	1.63	1955365	1039515	1.88
Sample-295	3826793	347751	3479042	182673	204263	0.89	13528	2387307	34460525	1439486	1.66	1953670	1039660	1.88
Sample-296	3770664	310430	3460234	177582	197995	0.9	16524	2370266	34477975	1400398	1.69	1982262	1040787	1.9
Sample-297	4323150	371796	3951354	199323	230234	0.87	44795	2972566	33912827	1350584	2.2	2291780	1197664	1.91
Sample-298	3863988	342035	3521953	184604	203813	0.91	14401	2470646	34412983	1393342	1.77	1979965	1052000	1.88
Sample-299	3832997	330119	3502878	182597	201148	0.91	15066	2421005	34431108	1411992	1.71	1971065	1044389	1.89
Sample-300	3874658	352007	3522651	184460	206659	0.89	13938	2494262	34404056	1380396	1.81	1979724	1052728	1.88
Sample-301	4424809	384944	4039865	202375	238208	0.85	52843	2965495	33771685	1459314	2.03	2356893	1227067	1.92
Sample-302	3816371	319283	3497088	181044	199253	0.91	14034	2413580	34450225	1402791	1.72	1969394	1041441	1.89
Sample-303	4566057	431476	4134581	211513	249607	0.85	56655	3072985	33711796	1493072	2.06	2366988	1247774	1.9
Sample-304	3724115	308307	3415808	176021	193146	0.91	14391	2262719	34507312	1461396	1.55	1943583	1025607	1.9
Sample-305	3729423	308070	3421353	176423	194564	0.91	12964	2285993	34503486	1443430	1.58	1948692	1028364	1.89
Sample-306	3832278	325405	3506873	181957	201202	0.9	17793	2437988	34440786	1394290	1.75	1983605	1048553	1.89
Sample-307	3721180	315702	3405478	175730	196197	0.9	14555	2296289	34517482	1424891	1.61	1948167	1025599	1.9
Sample-308	3859552	353868	3505684	184401	205825	0.9	14674	2410908	34422963	1448644	1.66	1958194	1044902	1.87
Sample-309	4400656	391807	4008849	204211	236154	0.86	46763	2945507	33849600	1455149	2.02	2299842	1208315	1.9
Sample-310	3811846	332133	3479713	181663	201351	0.9	13755	2368004	34453902	1443842	1.64	1959628	1039462	1.89
Sample-311	3713378	298577	3414801	175393	193461	0.91	13586	2296986	34476150	1416392	1.62	1949001	1024132	1.9
Sample-312	3776568	316632	3459936	178463	198419	0.9	17427	2398821	34465326	1377747	1.74	1972019	1037640	1.9
Sample-313	4470536	405188	4065348	205406	239654	0.86	50690	3007317	33744761	1463219	2.06	2359681	1236950	1.91
Sample-314	3887496	351982	3535514	185975	206746	0.9	14559	2491688	34408023	1395808	1.79	1974587	1052578	1.88
Sample-315	3806967	333776	3473191	181411	200852	0.9	13782	2359536	34467864	1447431	1.63	1950213	1037877	1.88
Sample-316	4628162	444775	4183387	214391	252701	0.85	60820	3117192	33645543	1510970	2.06	2405553	1266322	1.9
Sample-317	3839133	336148	3502985	183410	203059	0.9	15372	2438247	34438370	1400886	1.74	1963265	1040891	1.89
Sample-318	3858437	341227	3517210	183276	204507	0.9	15414	2447928	34413353	1410509	1.74	1973596	1048543	1.88
Sample-319	3874554	349573	3524981	185199	206490	0.9	14719	2480166	34414767	1394388	1.78	1969484	1048162	1.88
Sample-320	4296620	387329	3909291	200373	228957	0.88	38828	2989910	33942329	1306710	2.29	2241299	1179052	1.9
Sample-321	3836007	341557	3494450	183552	202357	0.91	15259	2381628	34452553	1454379	1.64	1959869	1041560	1.88
Sample-322	3770402	305757	3464645	178339	196439	0.91	13511	2373115	34453629	1397287	1.7	1967703	1035727	1.9
Sample-323	3678184	283407	3394777	174160	189663	0.92	13933	2241182	34492536	1437002	1.56	1936149	1014938	1.91
Sample-324	3841079	339336	3501743	183743	202727	0.91	14367	2448749	34447058	1392330	1.76	1966944	1043371	1.89
Sample-325	3785479	337289	3448190	179848	198673	0.91	21544	2351143	34353061	1434336	1.64	1953720	1030880	1.9
Sample-326	4546896	416687	4130209	208329	246347	0.85	60461	3028716	33692105	1518180	1.99	2385630	1252624	1.9
Sample-327	4578289	437613	4140676	211686	249430	0.85	57063	3109255	33683687	1469034	2.12	2378541	1253894	1.9
Sample-328	3752492	314126	3438366	178122	195842	0.91	14735	2313556	34488369	1438936	1.61	1947199	1028692	1.89
Sample-329	3775859	300221	3475638	177999	196001	0.91	14867	2370274	34468874	1405585	1.69	1965045	1035519	1.9
Sample-330	3796251	324729	3471522	180123	198743	0.91	14346	2359369	34463639	1436882	1.64	1967392	1040051	1.89
Sample-331	3869155	344667	3524488	183902	204663	0.9	20256	2471343	34423837	1397812	1.77	1987243	1054507	1.88
Sample-332	3743772	324207	3419565	177276	199818	0.89	64826	2164314	34487109	1579458	1.37	1943879	1027569	1.89
Sample-333	3825194	333033	3492161	182143	201219	0.91	16617	2404328	34434150	1420866	1.69	1964721	1041477	1.89
Sample-334	3801868	312962	3488906	179834	198741	0.9	21225	2392028	34439389	1409840	1.7	1981166	1042115	1.9
Sample-335	3837178	348717	3488461	182431	205152	0.89	13631	2400233	34436229	1436945	1.67	1955483	1040932	1.88
Sample-336	3763487	314083	3449404	179012	196294	0.91	13403	2313982	34506410	1449505	1.6	1945995	1030209	1.89
Sample-337	3830281	330056	3500225	181825	201089	0.9	14936	2444311	34416590	1385970	1.76	1980670	1046875	1.89
Sample-338	4560785	401253	4159532	209379	246665	0.85	62126	3118401	33678751	1442384	2.16	2414062	1258726	1.92
Sample-339	3826432	344634	3481798	182296	204726	0.89	13178	2384464	34448675	1441968	1.65	1959188	1043752	1.88
Sample-340	3871012	357050	3513962	183391	206656	0.89	14357	2438444	34413701	1432568	1.7	1975245	1054016	1.87
Sample-341	3776849	317647	3459202	179466	198185	0.91	12820	2339361	34568331	1437488	1.63	1960684	1035633	1.89
Sample-342	3836710	346377	3490333	181821	203120	0.9	15665	2432327	34459836	1404383	1.73	1977064	1050261	1.88
Sample-343	3773168	312138	3461030	179099	198298	0.9	14107	2361977	34482816	1411191	1.67	1956304	1032298	1.9
Sample-344	3863260	353332	3509928	184435	206696	0.89	13305	2408317	34440274	1454943	1.66	1958014	1046672	1.87
Sample-345	3788826	332751	3456075	179531	201469	0.89	14072	2359010	34459132	1429816	1.65	1952057	1034729	1.89
Sample-346	3796950	338730	3458220	181157	201890	0.9	16401	2346379	34490984	1450571	1.62	1944926	1034690	1.88
Sample-347	3898886	332020	3566866	185007	205956	0.9	20009	2521230	34381767	1377656	1.83	2012868	1065795	1.89
Sample-348	3743001	306174	3436827	177499	195581	0.91	14509	2289389	34517272	1453612	1.57	1948309	1027739	1.9
Sample-349	3834169	350107	3484062	182514	205477	0.89	28148	2400061	34435442	1434108	1.67	1969569	1045822	1.88
Sample-350	3776214	325830	3450384	179361	199944	0.9	13404	2342679	34488109	1433535	1.63	1946004	1030576	1.89
Sample-351	3770619	315154	3455465	179345	198920	0.9	12863	2335968	34487894	1434651	1.63	1947845	1030555	1.89
Sample-352	3767827	319944	3447883	177661	197811	0.9	12913	2321949	34474699	1445878	1.61	1964222	1036445	1.9
Sample-353	3881188	356388	3524800	185571	209000	0.89	15743	2470099	34435978	1411089	1.75	1964454	1052165	1.87
Sample-354	3751431	322058	3429373	177726	199743	0.89	12530	2332183	34504647	1419248	1.64	1929916	1024523	1.88
Sample-355	3807300	336584	3470716	180671	201776	0.9	13568	2382470	34474308	1424830	1.67	1961772	1039621	1.89
Sample-356	3694783	288271	3406512	174818	190250	0.92	13835	2255686	34556190	1439097	1.57	1948734	1022341	1.91
Sample-357	3815296	318703	3496593	181670	200262	0.91	14315	2412267	34472269	1403029	1.72	1975039	1043656	1.89
Sample-358	3749553	316359	3433194	178737	195897	0.91	15638	2316902	34603905	1432651	1.62	1954747	1032532	1.89
Sample-359	4478592	402109	4076483	206128	243299	0.85	54793	3018013	33780409	1460579	2.07	2347826	1232896	1.9
Sample-360	3850489	353341	3497148	184002	206676	0.89	14576	2409964	34447168	1440525	1.67	1949051	1041818	1.87
Sample-361	4561119	439490	4121629	211060	250735	0.84	56250	3070573	33718782	1490546	2.06	2365630	1249725	1.89
Sample-362	3765884	314101	3451783	178797	196934	0.91	19441	2329203	34498358	1436681	1.62	1956245	1033035	1.89
Sample-363	3892208	352404	3539804	184441	208128	0.89	14282	2491491	34412147	1400717	1.78	1987512	1059120	1.88
Sample-364	3829004	331991	3497013	181375	203854	0.89	15547	2420255	34442410	1408749	1.72	1968675	1042589	1.89
Sample-365	3853541	345114	3508427	183152	205358	0.89	14218	2410850	34404802	1442691	1.67	1967249	1046133	1.88
Sample-366	4612908	445740	4167168	212018	254625	0.83	58723	3107608	33663827	1505300	2.06	2404896	1265848	1.9
Sample-367	3777877	319563	3458314	180075	200224	0.9	13319	2357106	34477855	1420771	1.66	1950505	1032018	1.89
Sample-368	3723241	313668	3409573	174834	196290	0.89	14172	2275547	34506355	1447694	1.57	1949860	1026350	1.9
Sample-369	4665447	440538	4224909	215726	254660	0.85	61191	3240523	33636068	1424924	2.27	2425341	1278981	1.9
Sample-370	3731949	309581	3422368	177021	195643	0.9	13150	2280316	34518541	1451633	1.57	1938809	1023600	1.89
Sample-371	4628146	442137	4186009	213103	255379	0.83	57214	3183889	33650814	1444257	2.2	2403420	1268055	1.9
Sample-372	3783023	323510	3459513	178742	199372	0.9	14579	2358541	34453887	1424482	1.66	1962484	1036910	1.89
Sample-373	4545538	422741	4122797	209810	248852	0.84	55083	3056393	33734051	1489145	2.05	2360131	1243201	1.9
Sample-374	3778822	324880	3453942	178540	202113	0.88	18431	2335606	34459696	1443216	1.62	1958185	1036126	1.89
Sample-375	3792314	330586	3461728	180133	201345	0.89	12369	2350095	34468032	1442219	1.63	1956600	1037993	1.88
Sample-376	3860665	339239	3521426	183203	204314	0.9	15240	2443506	34418763	1417159	1.72	1987804	1055484	1.88
Sample-377	3826840	343837	3483003	182036	205278	0.89	63279	2242025	34450720	1584815	1.41	1956043	1041653	1.88
Sample-378	3798811	331503	3467308	181257	202368	0.9	13560	2337564	34473290	1461247	1.6	1941429	1032604	1.88
Sample-379	3788305	330326	3457979	180165	202075	0.89	12612	2341646	34461671	1446659	1.62	1953031	1034453	1.89
Sample-380	3801332	342350	3458982	180876	203306	0.89	13485	2369832	34493747	1431500	1.66	1949221	1035413	1.88
Sample-381	3819990	326343	3493647	181302	201579	0.9	16149	2413266	34433823	1406724	1.72	1969155	1042578	1.89
Sample-382	3699062	288977	3410085	173492	190833	0.91	12425	2276059	34563036	1423003	1.6	1960810	1026460	1.91
Sample-383	3767325	328277	3439048	179665	200120	0.9	12918	2330143	34513419	1437182	1.62	1932357	1026171	1.88
Sample-384	4126240	375604	3750636	194060	221774	0.88	31650	2699690	34155158	1426550	1.89	2116337	1123772	1.88
Sample-385	3770196	316117	3454079	178670	199038	0.9	14374	2334198	34467951	1435998	1.63	1951602	1032862	1.89
Sample-386	3847502	345856	3501646	183376	206317	0.89	13148	2388755	34418035	1458747	1.64	1954572	1042819	1.87
Sample-387	4514007	396574	4117433	207641	243111	0.85	57582	3116158	33735249	1397849	2.23	2382709	1247408	1.91
Sample-388	3751795	299635	3452160	176573	197278	0.9	15431	2350290	34479414	1401505	1.68	1966348	1033905	1.9
Sample-389	3849041	351129	3497912	183530	206464	0.89	15457	2427395	34439298	1421646	1.71	1955812	1043333	1.87
Sample-390	3837636	351234	3486402	183327	204813	0.9	12950	2392644	34447917	1444992	1.66	1947711	1039885	1.87
Sample-391	3792764	323747	3469017	180466	201586	0.9	13295	2358479	34464331	1434285	1.64	1954389	1036409	1.89
Sample-392	3826246	350082	3476164	183068	205057	0.89	13117	2377854	34485517	1448392	1.64	1936766	1033259	1.87
Sample-393	3766744	318412	3448332	179248	198393	0.9	12829	2337399	34562110	1429345	1.64	1955920	1033690	1.89
Sample-394	3796188	330855	3465333	181044	201053	0.9	14988	2369192	34473103	1426996	1.66	1947061	1035163	1.88
Sample-395	3937139	354222	3582917	185882	209823	0.89	21482	2566767	34344827	1370372	1.87	2027174	1075633	1.88
Sample-396	3789601	314979	3474622	180554	199046	0.91	14213	2370568	34488488	1419033	1.67	1957084	1038055	1.89
Sample-397	3869883	346041	3523842	184745	206537	0.89	13705	2455120	34437216	1414763	1.74	1967775	1047912	1.88
Sample-398	3804057	329508	3474549	180618	201333	0.9	16579	2400827	34463901	1403230	1.71	1961331	1039336	1.89
Sample-399	3827718	344639	3483079	181563	204154	0.89	14973	2385493	34447025	1442225	1.65	1959681	1042594	1.88
Sample-400	3816092	336165	3479927	181792	202718	0.9	13800	2353464	34431717	1462628	1.61	1957381	1038768	1.88
Sample-401	3782074	322277	3459797	179174	199985	0.9	14336	2348720	34463845	1433354	1.64	1954618	1034309	1.89
Sample-402	3823197	330305	3492892	180852	202202	0.89	14879	2410373	34447047	1412824	1.71	1981424	1048745	1.89
Sample-403	3794100	331834	3462266	180617	201952	0.89	13603	2342989	34470618	1451111	1.61	1944679	1033129	1.88
Sample-404	3821223	333507	3487716	181895	203369	0.89	14537	2380465	34445622	1440758	1.65	1961885	1041717	1.88
Sample-405	4586730	433248	4153482	211839	250652	0.85	57587	3183559	33690294	1403171	2.27	2382387	1254972	1.9
Sample-406	3791055	322733	3468322	179217	200170	0.9	14204	2399743	34416214	1391312	1.72	1965981	1038436	1.89
Sample-407	4525212	410992	4114220	208494	245838	0.85	55691	3124090	33717775	1401122	2.23	2371931	1243183	1.91
Sample-408	3774619	335560	3439059	178632	200686	0.89	14982	2348585	34459036	1426034	1.65	1946099	1031888	1.89
Sample-409	3862864	342493	3520371	184370	206840	0.89	14027	2465502	34410712	1397362	1.76	1974314	1047913	1.88
Sample-410	3798577	331932	3466645	181127	202247	0.9	13269	2375890	34453827	1422687	1.67	1946127	1034336	1.88
Sample-411	3797576	336673	3460903	179003	200881	0.89	20841	2374274	34441123	1423302	1.67	1969303	1041342	1.89
Sample-412	3820750	334029	3486721	180913	203035	0.89	19939	2432073	34438270	1388677	1.75	1971853	1046008	1.89
Sample-413	3722162	304472	3417690	174807	195276	0.9	15722	2294018	34494906	1428144	1.61	1956783	1029422	1.9
Sample-414	3863671	345115	3518556	183250	206664	0.89	14727	2476853	34427683	1386818	1.79	1973216	1049560	1.88
Sample-415	3838111	343927	3494184	182965	205279	0.89	12443	2394469	34453207	1443642	1.66	1947677	1040353	1.87
Sample-416	3741595	309033	3432562	178047	197512	0.9	12811	2303846	34477894	1437749	1.6	1937614	1024106	1.89
Sample-417	3814976	329432	3485544	180885	201136	0.9	21209	2363366	34419393	1451610	1.63	1975962	1045106	1.89
Sample-418	3827787	346463	3481324	181533	204775	0.89	15090	2404789	34457523	1422998	1.69	1957865	1043510	1.88
Sample-419	3781849	316707	3465142	178573	198408	0.9	15001	2379393	34464548	1402456	1.7	1981773	1041659	1.9
Sample-420	3850793	368626	3482167	181271	205315	0.88	61095	2373251	34408145	1477542	1.61	2001072	1058657	1.89
Sample-421	4471032	412551	4058481	206046	243477	0.85	49189	3025374	33789070	1445658	2.09	2348701	1233283	1.9
Sample-422	3741938	319670	3422268	176732	198345	0.89	13519	2307976	34510085	1433962	1.61	1952967	1029262	1.9
Sample-423	3963237	353037	3610200	186113	211741	0.88	26807	2579007	34292856	1384230	1.86	2054373	1085544	1.89
Sample-424	3787998	332337	3455661	178134	199643	0.89	24975	2353896	34457284	1434102	1.64	1983170	1045109	1.9
Sample-425	3787568	334855	3452713	179332	201549	0.89	13628	2354600	34478698	1432968	1.64	1954585	1036609	1.89
Sample-426	4521327	411200	4110127	206712	245675	0.84	55732	3104636	33725771	1416691	2.19	2387765	1248777	1.91
Sample-427	3769365	320935	3448430	178616	198342	0.9	13652	2332146	34481967	1437219	1.62	1962911	1038218	1.89
Sample-428	3763575	323130	3440445	178388	198596	0.9	13796	2332536	34467340	1431039	1.63	1945714	1028761	1.89
Sample-429	3808992	336721	3472271	180424	203580	0.89	12647	2359703	34451641	1449289	1.63	1958570	1040611	1.88
Sample-430	3827771	344603	3483168	181900	204698	0.89	13314	2386613	34436167	1441158	1.66	1954667	1040407	1.88
Sample-431	3767732	302885	3464847	177938	197668	0.9	13849	2351219	34457197	1416513	1.66	1970241	1037001	1.9
Sample-432	3788520	334361	3454159	178844	201301	0.89	15128	2332798	34502349	1455722	1.6	1964084	1040107	1.89
Sample-433	3833731	342048	3491683	180609	203643	0.89	20333	2441583	34413244	1392148	1.75	1985786	1050568	1.89
Sample-434	3763741	318233	3445508	176504	195833	0.9	16309	2374010	34406873	1389731	1.71	1964955	1036088	1.9
Sample-435	3746669	306282	3440387	177734	196314	0.91	13360	2345850	34518096	1400819	1.67	1958317	1028525	1.9
Sample-436	3780407	328935	3451472	179798	200613	0.9	12236	2336909	34473639	1443498	1.62	1950149	1033775	1.89
Sample-437	3828190	329295	3498895	180778	203298	0.89	14471	2415315	34418883	1412875	1.71	1977267	1046869	1.89
Sample-438	3942777	356530	3586247	186083	211931	0.88	27629	2539970	34323514	1402807	1.81	2021920	1075620	1.88
Sample-439	4422665	412336	4010329	204290	238102	0.86	51271	2995910	33694157	1426755	2.1	2318383	1213953	1.91
Sample-440	4497191	436816	4060375	209442	241615	0.87	52884	3026750	33602170	1470441	2.06	2337974	1228477	1.9
Sample-441	3787683	350406	3437277	182137	199058	0.91	13418	2360429	34265546	1427254	1.65	1915802	1020432	1.88
Sample-442	3783599	335162	3448437	179921	197419	0.91	23417	2350866	34384247	1432733	1.64	1949432	1030609	1.89
Sample-443	3770212	337076	3433136	179846	196103	0.92	13836	2382770	34368195	1387442	1.72	1940100	1025610	1.89
Sample-444	3852967	342182	3510785	183607	204808	0.9	15499	2445973	34488774	1406994	1.74	1976796	1050088	1.88
Sample-445	3736200	320828	3415372	178518	198392	0.9	61434	2165685	34582734	1570515	1.38	1963013	1036931	1.89
Sample-446	3759652	328642	3431010	179738	200098	0.9	13495	2361434	34501131	1398218	1.69	1951877	1031230	1.89
Sample-447	3768093	327602	3440491	177705	198284	0.9	14522	2333193	34465982	1434900	1.63	1958852	1035353	1.89
Sample-448	3767265	325418	3441847	180505	198654	0.91	16384	2342751	34562102	1424514	1.64	1967565	1036560	1.9
Sample-449	3597958	316647	3281311	171933	187310	0.92	13818	2199488	34103303	1398470	1.57	1886962	988643	1.91
Sample-450	3794691	335881	3458810	182298	200923	0.91	13848	2372277	34558969	1422414	1.67	1969506	1042465	1.89
Sample-451	3805966	329305	3476661	178041	201068	0.89	21075	2380741	34447886	1425225	1.67	1988715	1050684	1.89
Sample-452	3775591	314175	3461416	179935	198153	0.91	15709	2393800	34580427	1381791	1.73	1987144	1046351	1.9
Sample-453	3765309	334709	3430600	181517	202356	0.9	14435	2332528	34599977	1432781	1.63	1943001	1029852	1.89
Sample-454	3790394	334478	3455916	182754	202565	0.9	16821	2395789	34582360	1394605	1.72	1967680	1041238	1.89
Sample-455	3768461	327767	3440694	180746	197645	0.91	14432	2383845	34490562	1384616	1.72	1958839	1033052	1.9
Sample-456	3764037	318127	3445910	180332	199806	0.9	13079	2364560	34595147	1399477	1.69	1973580	1039795	1.9
Sample-457	3753212	324941	3428271	180745	199759	0.9	14467	2319219	34618531	1433993	1.62	1952875	1031676	1.89
Sample-458	4560131	431841	4128290	207833	247900	0.84	54507	3083178	33680648	1476953	2.09	2396453	1260204	1.9
Sample-459	4036747	362810	3673937	192131	215814	0.89	32555	2640460	34330784	1396287	1.89	2116640	1115451	1.9
Sample-460	3792297	324530	3467767	181930	202430	0.9	15230	2384206	34561362	1408091	1.69	1974017	1042190	1.89
Sample-461	4746755	506910	4239845	225425	262063	0.86	58246	3192433	33719242	1554322	2.05	2431134	1293184	1.88
Sample-462	3780721	327993	3452728	177372	198769	0.89	13765	2381741	34430432	1398980	1.7	1969533	1038526	1.9
Sample-463	3914363	369266	3545097	191086	205291	0.93	16268	2530268	34551349	1384095	1.83	1997197	1066319	1.87
Sample-464	3728571	321181	3407390	178889	196765	0.91	13579	2306749	34636384	1421822	1.62	1952071	1027813	1.9
Sample-465	3824222	350690	3473532	185163	203400	0.91	15737	2390975	34579756	1433247	1.67	1967890	1046300	1.88
Sample-466	3803542	361899	3441643	181586	202603	0.9	60985	2346493	34552661	1457049	1.61	1996529	1053845	1.89
Sample-467	3712289	305700	3406589	176959	194986	0.91	15844	2313424	34638026	1398865	1.65	1964810	1031093	1.91
Sample-468	3728111	315229	3412882	178540	197146	0.91	13074	2284987	34625217	1443124	1.58	1957626	1031356	1.9
Sample-469	3807638	333862	3473776	183111	202888	0.9	15413	2418084	34575228	1389554	1.74	1982085	1048337	1.89
Sample-470	3737244	321219	3416025	180202	198440	0.91	13862	2288090	34625762	1449154	1.58	1947786	1029203	1.89
Sample-471	3945935	407101	3538834	193464	208246	0.93	34010	2524877	34520548	1421058	1.78	1993775	1068443	1.87
Sample-472	3771381	316233	3455148	181061	199596	0.91	13970	2394012	34583070	1377369	1.74	1975246	1041682	1.9
Sample-473	3754852	324216	3430636	176092	198561	0.89	15004	2339000	34442081	1415852	1.65	1953867	1032190	1.89
Sample-474	4449350	402450	4046900	206814	241712	0.86	52504	2994155	33876865	1455195	2.06	2366467	1237066	1.91
Sample-475	3805737	341013	3464724	183681	203324	0.9	16293	2377751	34569243	1427986	1.67	1973099	1046704	1.89
Sample-476	3780414	321266	3459148	179300	198051	0.91	23216	2375695	34557797	1404719	1.69	1998998	1050877	1.9
Sample-477	4570125	441697	4128428	213573	253743	0.84	57283	3077109	33781942	1493016	2.06	2383721	1256632	1.9
Sample-478	3894367	371652	3522715	191371	206015	0.93	14058	2459160	34559876	1435207	1.71	1969754	1054913	1.87
Sample-479	3757061	314574	3442487	177689	196587	0.9	14374	2317600	34478210	1439461	1.61	1963531	1035280	1.9
Sample-480	3757452	314597	3442855	178871	197096	0.91	13981	2366233	34590239	1391219	1.7	1977562	1040817	1.9
Sample-481	3836652	349331	3487321	185462	205406	0.9	13406	2384871	34540929	1451781	1.64	1959310	1045473	1.87
Sample-482	3943418	398270	3545148	194660	209311	0.93	14563	2502092	34530078	1441326	1.74	1972282	1060293	1.86
Sample-483	3741116	318243	3422873	178489	198029	0.9	13616	2306467	34610700	1434649	1.61	1959466	1033176	1.9
Sample-484	3820367	330670	3489697	182849	202954	0.9	53645	2338898	34535139	1481469	1.58	2002167	1057236	1.89
Sample-485	4673415	489776	4183639	224207	256294	0.87	56621	3217619	33781395	1455796	2.21	2383863	1265693	1.88
Sample-486	3801784	333707	3468077	178342	201513	0.89	14197	2380880	34403515	1420904	1.68	1973245	1044856	1.89
Sample-487	3788197	327560	3460637	179454	198062	0.91	19757	2370977	34437254	1417220	1.67	1959513	1034992	1.89
Sample-488	3741609	312133	3429476	178569	196947	0.91	13982	2361243	34596121	1380366	1.71	1970629	1035589	1.9
Sample-489	3860526	350380	3510146	184977	206258	0.9	19255	2474509	34484581	1386017	1.79	1987089	1054150	1.89
Sample-490	3785679	320108	3465571	180645	199970	0.9	15850	2389927	34573583	1395752	1.71	1985395	1047416	1.9
Sample-491	3686275	295029	3391246	172919	192439	0.9	12653	2251485	34532435	1434790	1.57	1939803	1019236	1.9
Sample-492	3672826	291824	3381002	172175	190438	0.9	12672	2246764	34513721	1426062	1.58	1945099	1018901	1.91
Sample-493	3750301	323182	3427119	176377	196887	0.9	12724	2325059	34469367	1425242	1.63	1954061	1032278	1.89
Sample-494	3753344	322033	3431311	176913	197531	0.9	15614	2329301	34477663	1424043	1.64	1958609	1033424	1.9
Sample-495	3842906	345914	3496992	185025	207753	0.89	16201	2447266	34532951	1395640	1.75	1979075	1051770	1.88
Sample-496	3730830	309498	3421332	175798	195189	0.9	14834	2286977	34500915	1443853	1.58	1946919	1025155	1.9
Sample-497	4507632	418597	4089035	211375	246204	0.86	51852	3064496	33837567	1443136	2.12	2357549	1240579	1.9
Sample-498	3743057	326065	3416992	180029	199066	0.9	13910	2307502	34639359	1435555	1.61	1952127	1032209	1.89
Sample-499	3763020	320361	3442659	180977	200265	0.9	15982	2324395	34596942	1438625	1.62	1963073	1036817	1.89
Sample-500	3700914	304112	3396802	172336	193556	0.89	12632	2262016	34473683	1438898	1.57	1950954	1025297	1.9
Sample-501	3790168	338424	3451744	182121	202941	0.9	13673	2357839	34549008	1432329	1.65	1947408	1034341	1.88
Sample-502	3878454	358869	3519585	187588	208668	0.9	14923	2466438	34507491	1412016	1.75	1979214	1052694	1.88
Sample-503	3758983	332739	3426244	182392	200199	0.91	13388	2318292	34626343	1440691	1.61	1940272	1028332	1.89
Sample-504	3776734	340070	3436664	178188	199683	0.89	14479	2296728	34486795	1480006	1.55	1946278	1034165	1.88
Sample-505	3793029	339980	3453049	182923	202137	0.9	13602	2354216	34589529	1438813	1.64	1959498	1040930	1.88
Sample-506	3780488	314223	3466265	177379	197285	0.9	16904	2375880	34467226	1404608	1.69	1983903	1043435	1.9
Sample-507	3809537	330936	3478601	183175	203115	0.9	17928	2415255	34556549	1394282	1.73	1978013	1046214	1.89
Sample-508	3862973	333294	3529679	183090	204278	0.9	27275	2444198	34464984	1418775	1.72	2034721	1071275	1.9
Sample-509	3748065	325529	3422536	179347	198996	0.9	13275	2327358	34536140	1420707	1.64	1947253	1029210	1.89
Sample-510	3788490	339635	3448855	181470	199574	0.91	14173	2387634	34508498	1400856	1.7	1960126	1037920	1.89
Sample-511	3717228	311824	3405404	174223	194953	0.89	12928	2280800	34485690	1436428	1.59	1949038	1026184	1.9
Sample-512	3763518	333423	3430095	180705	200441	0.9	11703	2348875	34626693	1414643	1.66	1962329	1037695	1.89
Sample-513	3804852	322460	3482392	180115	198931	0.91	14453	2411555	34437533	1393297	1.73	1970967	1040303	1.89
Sample-514	3766331	331660	3434671	180296	200582	0.9	13098	2342675	34593719	1423656	1.65	1956290	1037263	1.89
Sample-515	3834543	335110	3499433	180332	202998	0.89	14503	2486186	34407539	1348357	1.84	1985378	1048213	1.89
Sample-516	3785170	320107	3465063	181009	200143	0.9	17913	2385228	34567258	1399942	1.7	1989972	1049737	1.9
Sample-517	3743156	312325	3430831	179073	194804	0.92	14946	2309081	34616291	1434075	1.61	1977367	1040135	1.9
Sample-518	3958902	350165	3608737	188586	213744	0.88	27806	2566783	34392345	1392119	1.84	2059691	1087317	1.89
Sample-519	3766679	327643	3439036	181151	201708	0.9	14281	2337243	34607827	1429436	1.64	1951803	1035172	1.89
Sample-520	3779198	334387	3444811	178297	200107	0.89	15372	2336885	34451525	1442313	1.62	1954320	1033083	1.89
Sample-521	3787449	332098	3455351	182272	203064	0.9	15107	2391790	34603098	1395659	1.71	1973584	1042995	1.89
Sample-522	3772809	329239	3443570	181091	201062	0.9	18847	2353074	34584846	1419735	1.66	1959889	1038256	1.89
Sample-523	3761811	314128	3447683	175594	197067	0.89	14922	2363386	34470725	1398425	1.69	1975076	1041526	1.9
Sample-524	3774215	322873	3451342	180949	200227	0.9	16118	2357419	34585996	1416796	1.66	1974419	1041242	1.9
Sample-525	3729907	306896	3423011	174335	194918	0.89	13580	2349679	34498500	1380228	1.7	1959774	1031865	1.9
Sample-526	3770313	316959	3453354	177435	196936	0.9	15467	2336790	34467988	1433523	1.63	1971906	1039057	1.9
Sample-527	4020302	355067	3665235	191264	215800	0.89	30611	2638606	34339284	1381696	1.91	2100230	1108295	1.9
Sample-528	4556000	427559	4128441	212024	251457	0.84	60331	3051594	33790080	1504406	2.03	2398130	1258192	1.91
Sample-529	3823988	334712	3489276	178973	203235	0.88	15456	2426872	34400936	1397116	1.74	1985281	1049535	1.89
Sample-530	3764869	318344	3446525	176346	198376	0.89	13154	2370087	34488432	1394782	1.7	1972458	1038923	1.9
Sample-531	3776970	326315	3450655	175151	199519	0.88	26199	2385197	34417321	1391773	1.71	1984309	1041598	1.91
Sample-532	3717758	299199	3418559	173731	193648	0.9	14047	2270219	34470966	1447539	1.57	1959766	1027119	1.91
Sample-533	4461290	395626	4065664	203378	239591	0.85	51252	3097097	33734257	1364193	2.27	2358122	1233347	1.91
Sample-534	3738760	297775	3440985	175484	194237	0.9	13951	2340117	34430177	1398643	1.67	1955819	1027345	1.9
Sample-535	3845866	337370	3508496	181826	201654	0.9	14924	2433906	34399745	1411960	1.72	1974910	1045811	1.89
Sample-536	3804546	336561	3467985	179808	197439	0.91	16418	2361619	34450045	1442927	1.64	1967830	1045296	1.88
Sample-537	3770041	320389	3449652	176151	198565	0.89	15377	2373105	34449641	1396936	1.7	1965977	1038971	1.89
Sample-538	3841308	346114	3495194	181735	201148	0.9	13708	2446522	34432323	1394786	1.75	1976068	1049161	1.88
Sample-539	3845999	345388	3500611	181990	202792	0.9	12958	2437937	34418588	1408062	1.73	1970453	1045035	1.89
Sample-540	3815621	329714	3485907	181352	199163	0.91	15281	2421913	34439390	1393708	1.74	1966755	1040181	1.89
Sample-541	3754403	304821	3449582	175327	195253	0.9	14636	2353732	34441848	1400671	1.68	1979362	1039417	1.9
Sample-542	3783432	324734	3458698	177790	198671	0.89	14125	2364921	34435136	1418511	1.67	1965680	1039037	1.89
Sample-543	3839443	345417	3494026	181438	202298	0.9	15011	2418302	34404775	1421141	1.7	1971940	1046999	1.88
Sample-544	3788054	329698	3458356	179015	196567	0.91	20772	2361083	34439271	1426971	1.65	1958477	1036214	1.89
Sample-545	3757972	320660	3437312	176848	197321	0.9	13372	2324712	34472282	1433260	1.62	1952691	1031946	1.89
Sample-546	3797651	343894	3453757	178520	199425	0.9	14530	2379036	34401652	1418615	1.68	1963401	1036037	1.9
Sample-547	3780287	326630	3453657	177325	199953	0.89	16936	2340186	34425105	1440101	1.63	1963637	1037667	1.89
Sample-548	3866601	350574	3516027	183059	203813	0.9	14143	2479750	34399211	1386851	1.79	1984328	1055105	1.88
Sample-549	3814481	333018	3481463	180661	198940	0.91	13683	2379281	34441880	1435200	1.66	1970882	1045247	1.89
Sample-550	3798524	320259	3478265	179333	197737	0.91	14599	2380340	34459601	1418184	1.68	1981960	1047207	1.89
Sample-551	3938571	354966	3583605	185605	208386	0.89	20785	2559312	34341572	1379259	1.86	2026004	1075237	1.88
Sample-552	3802941	330348	3472593	179472	199717	0.9	13657	2379945	34446821	1422996	1.67	1965860	1039994	1.89
Sample-553	3854694	334372	3520322	181928	201673	0.9	14933	2456525	34388962	1398169	1.76	1989410	1053769	1.89
Sample-554	3799971	324694	3475277	178595	198889	0.9	16712	2401172	34398248	1398799	1.72	1972984	1039946	1.9
Sample-555	3815367	348221	3467146	179028	200515	0.89	21430	2383154	34426902	1432213	1.66	1977064	1046421	1.89
Sample-556	3863662	353630	3510032	183168	203029	0.9	14837	2471094	34417611	1392568	1.77	1980378	1052115	1.88
Sample-557	3808511	343051	3465460	179594	200830	0.89	14061	2382886	34409544	1425625	1.67	1959418	1038033	1.89
Sample-558	3791044	336757	3454287	177705	200209	0.89	24703	2378306	34431514	1412738	1.68	1969414	1042369	1.89
Sample-559	3771746	317978	3453768	177164	198458	0.89	14648	2352142	34449694	1419604	1.66	1965255	1037557	1.89
Sample-560	3837450	338830	3498620	180041	203319	0.89	15074	2448562	34396819	1388888	1.76	1978858	1049757	1.89
Sample-561	4384562	366920	4017642	198114	235556	0.84	58110	2911029	33797094	1473533	1.98	2371278	1226909	1.93
Sample-562	3684165	297348	3386817	174004	190981	0.91	14038	2266223	34571707	1417942	1.6	1954146	1021767	1.91
Sample-563	3701944	305120	3396824	176260	192714	0.91	13678	2260484	34629379	1441460	1.57	1952960	1025987	1.9
Sample-564	3754268	308581	3445687	178025	196722	0.9	26627	2313507	34561675	1440761	1.61	1987571	1042157	1.91
Sample-565	3682693	290528	3392165	173982	190993	0.91	14596	2280287	34622742	1402406	1.63	1964339	1027125	1.91
Sample-566	3734815	313407	3421408	178468	196121	0.91	14686	2306838	34593936	1427977	1.62	1969936	1036272	1.9
Sample-567	3715555	308237	3407318	176104	192614	0.91	15791	2324679	34623693	1390876	1.67	1975572	1036405	1.91
Sample-568	3808837	334847	3473990	183751	201864	0.91	13877	2367126	34571270	1441711	1.64	1956212	1039610	1.88
Sample-569	3773941	327930	3446011	181814	199311	0.91	14569	2331537	34583712	1442404	1.62	1958984	1035866	1.89
Sample-570	3693906	299862	3394044	174149	191344	0.91	15131	2269949	34595582	1423957	1.59	1969880	1030903	1.91
Sample-571	3825225	333463	3491762	183469	201445	0.91	15786	2425666	34543097	1399559	1.73	1970590	1045369	1.89
Sample-572	3761301	322817	3438484	179539	198349	0.91	15072	2363604	34591189	1397697	1.69	1970879	1038821	1.9
Sample-573	3761495	325427	3436068	176377	197546	0.89	13373	2336468	34435089	1425027	1.64	1955898	1032709	1.89
Sample-574	3812442	330665	3481777	182673	201702	0.91	13321	2386341	34548347	1426101	1.67	1963166	1041787	1.88
Sample-575	3757848	316230	3441618	180290	194022	0.93	14892	2303284	34604727	1454564	1.58	1966859	1037971	1.89
Sample-576	3686241	304799	3381442	175127	194039	0.9	14143	2281188	34623954	1405053	1.62	1949783	1022976	1.91
Sample-577	3794830	318731	3476099	179620	201230	0.89	16285	2359107	34516476	1435723	1.64	1998596	1049340	1.9
Sample-578	3732501	309949	3422552	178376	193304	0.92	13701	2294187	34632310	1438314	1.6	1954979	1032546	1.89
Sample-579	4381036	364964	4016072	199806	233664	0.86	56176	2885373	33847525	1495663	1.93	2371900	1227146	1.93
Sample-580	3767665	320939	3446726	181128	195092	0.93	13467	2336556	34610000	1431109	1.63	1957826	1037482	1.89
Sample-581	3695699	296754	3398945	175047	191717	0.91	13817	2258970	34597824	1436729	1.57	1961537	1027120	1.91
Sample-582	3741165	317809	3423356	177872	196215	0.91	13107	2292205	34592567	1448960	1.58	1964861	1036197	1.9
Sample-583	3674355	304180	3370175	173685	191587	0.91	14106	2251011	34648294	1423344	1.58	1949922	1022813	1.91
Sample-584	3699215	297567	3401648	176693	192755	0.92	14332	2251636	34610192	1447579	1.56	1957040	1026296	1.91
Sample-585	3747001	304378	3442623	175031	193540	0.9	13517	2345046	34409384	1401955	1.67	1960805	1028846	1.91
Sample-586	3718839	298652	3420187	177115	194222	0.91	15984	2320235	34612911	1398604	1.66	1971928	1033280	1.91
Sample-587	3741239	307658	3433581	177717	196561	0.9	16557	2330619	34574070	1410620	1.65	1981154	1038627	1.91
Sample-588	3687320	292255	3395065	175008	191821	0.91	14296	2302765	34629503	1384555	1.66	1962270	1026563	1.91
Sample-589	3785994	332695	3453299	182358	199315	0.91	13933	2350518	34570525	1435476	1.64	1948282	1035227	1.88
Sample-590	3656184	288009	3368175	173798	190192	0.91	13066	2219874	34642720	1436310	1.55	1937178	1014900	1.91
Sample-591	3672103	292256	3379847	174885	190878	0.92	13780	2249547	34622015	1422556	1.58	1950765	1021175	1.91
Sample-592	3715778	310898	3404880	176962	193576	0.91	14350	2269444	34621155	1446334	1.57	1963652	1032239	1.9
Sample-593	3755388	302618	3452770	177671	194839	0.91	20633	2371435	34561252	1383953	1.71	1995221	1044347	1.91
Sample-594	3702861	300343	3402518	175006	194874	0.9	68315	2157704	34570182	1545157	1.4	1963813	1029311	1.91
Sample-595	3643119	279567	3363552	171911	185416	0.93	14273	2211786	34624665	1431333	1.55	1951428	1016671	1.92
Sample-596	3733682	317262	3416420	176415	195077	0.9	22040	2302681	34482923	1431001	1.61	1971593	1033662	1.91
Sample-597	3626981	304943	3322038	169128	182725	0.93	21227	2207272	34565734	1419709	1.55	1930916	1008047	1.92
Sample-598	3708248	309497	3398751	176684	191368	0.92	12825	2276163	34639568	1432085	1.59	1954514	1028945	1.9
Sample-599	3678739	295922	3382817	173747	190800	0.91	14881	2258215	34628466	1420524	1.59	1956733	1025389	1.91
Sample-600	3774640	323328	3451312	177188	197198	0.9	13823	2349457	34483484	1425183	1.65	1969021	1039344	1.89
Sample-601	3785125	328757	3456368	176921	199710	0.89	64289	2230086	34433814	1555039	1.43	1972469	1042831	1.89
Sample-602	3786129	321841	3464288	181762	197097	0.92	14480	2370789	34602434	1415340	1.68	1970852	1040681	1.89
Sample-603	3705127	303392	3401735	176044	193702	0.91	14014	2262268	34623845	1442859	1.57	1959297	1028573	1.9
Sample-604	3677943	286897	3391046	174675	188895	0.92	12325	2257017	34628405	1420926	1.59	1958669	1022833	1.91
Sample-605	3663595	289249	3374346	173551	191842	0.9	13220	2244584	34602447	1419011	1.58	1949560	1018030	1.92
Sample-606	3667103	291950	3375153	174552	190631	0.92	12759	2242022	34632223	1425081	1.57	1940531	1017680	1.91
Sample-607	3755324	310201	3445123	178403	192669	0.93	16040	2366580	34587379	1388744	1.7	1983848	1043000	1.9
Sample-608	3745322	318511	3426811	178811	196085	0.91	17868	2333263	34582238	1412059	1.65	1968834	1035281	1.9
Sample-609	3731957	301674	3430283	176166	191810	0.92	19429	2362319	34581053	1369638	1.72	1982971	1038427	1.91
Sample-610	3796254	313903	3482351	179883	197046	0.91	26806	2409043	34518960	1387211	1.74	2009351	1053287	1.91
Sample-611	3709296	305363	3403933	178273	191900	0.93	13551	2278035	34636163	1431261	1.59	1949708	1026833	1.9
Sample-612	3689631	285731	3403900	173687	188230	0.92	13541	2300609	34605699	1389022	1.66	1981283	1032420	1.92
Sample-613	4427010	378470	4048540	204190	236165	0.86	56540	2972630	33858877	1454380	2.04	2364677	1233364	1.92
Sample-614	3744458	312978	3431480	178341	194707	0.92	12955	2307021	34604441	1437437	1.6	1967372	1036822	1.9
Sample-615	3748647	300045	3448602	178228	194324	0.92	15402	2374730	34579349	1373917	1.73	1985740	1041341	1.91
Sample-616	3644765	278801	3365964	172297	186635	0.92	14575	2204957	34630305	1439808	1.53	1952861	1017845	1.92
Sample-617	3706006	305992	3400014	176348	193395	0.91	14289	2269157	34622677	1436849	1.58	1955242	1027135	1.9
Sample-618	3672958	293185	3379773	175188	191356	0.92	13322	2254375	34641887	1418583	1.59	1948675	1021420	1.91
Sample-619	3811197	332288	3478909	183580	200836	0.91	15145	2405302	34564237	1405895	1.71	1973592	1045291	1.89
Sample-620	3714639	294575	3420064	176404	191530	0.92	15030	2313993	34608459	1400646	1.65	1973894	1032031	1.91
Sample-621	3676452	288834	3387618	174756	190350	0.92	13918	2251295	34623811	1425157	1.58	1948574	1021259	1.91
Sample-622	3785024	317246	3467778	180601	195196	0.93	15597	2381287	34573098	1403737	1.7	1974892	1041715	1.9
Sample-623	3687412	294993	3392419	175026	191271	0.92	14124	2258261	34636763	1429151	1.58	1961155	1027645	1.91
Sample-624	3763653	319511	3444142	180321	197622	0.91	13409	2309487	34590790	1454166	1.59	1951266	1033510	1.89
Sample-625	3910475	340059	3570416	182992	205663	0.89	29597	2515799	34325913	1394676	1.8	2036076	1073448	1.9
Sample-626	3728711	309075	3419636	177676	190985	0.93	15381	2282301	34610477	1446410	1.58	1950004	1030161	1.89
Sample-627	4423108	398356	4024752	205517	237833	0.86	47496	2964403	33900958	1458705	2.03	2341752	1226874	1.91
Sample-628	3739291	321831	3417460	179170	196342	0.91	13146	2294140	34614349	1445151	1.59	1950777	1030681	1.89
Sample-629	3788514	328981	3459533	181652	200309	0.91	13868	2408610	34586396	1379904	1.75	1968790	1042386	1.89
Sample-630	3707708	311477	3396231	176981	195039	0.91	12780	2256717	34623907	1450991	1.56	1946608	1024854	1.9
Sample-631	3782929	316288	3466641	177529	196216	0.9	14314	2372060	34448112	1410869	1.68	1981664	1043932	1.9
Sample-632	3793669	328854	3464815	182389	199075	0.92	14321	2338123	34591902	1455546	1.61	1964088	1041148	1.89
Sample-633	3771720	320366	3451354	181266	197355	0.92	14688	2344702	34597396	1427018	1.64	1965231	1037890	1.89
Sample-634	3754643	323793	3430850	179046	197039	0.91	19111	2331331	34590040	1423312	1.64	1946958	1030932	1.89
Sample-635	3655585	281757	3373828	172428	188998	0.91	13453	2226274	34632215	1429311	1.56	1953009	1019044	1.92
Sample-636	3722094	312345	3409749	177940	196292	0.91	15887	2298132	34608139	1423962	1.61	1941270	1026252	1.89
Sample-637	4439361	383325	4056036	205419	238674	0.86	50407	3110316	33866172	1329045	2.34	2357590	1232475	1.91
Sample-638	3718510	291140	3427370	175945	192609	0.91	14413	2338385	34589713	1380125	1.69	1982594	1035295	1.92
Sample-639	3915717	374390	3541327	190328	205778	0.92	14808	2507738	34535394	1407979	1.78	1982290	1059779	1.87
Sample-640	3774070	327770	3446300	180398	198412	0.91	16661	2387062	34611312	1387008	1.72	1982124	1043790	1.9
Sample-641	3743376	306234	3437142	176373	193614	0.91	14556	2339566	34578245	1403810	1.67	1987407	1043446	1.9
Sample-642	3747564	321939	3425625	175889	197965	0.89	14145	2322854	34524809	1424710	1.63	1959482	1034236	1.89
Sample-643	3733607	317970	3415637	178605	196912	0.91	13081	2288396	34619760	1445211	1.58	1958474	1034675	1.89
Sample-644	3776606	315291	3461315	178328	198526	0.9	15252	2378286	34542765	1398320	1.7	1982255	1044378	1.9
Sample-645	3706897	312944	3393953	177360	195505	0.91	13359	2293849	34637539	1413048	1.62	1951168	1027149	1.9
Sample-646	3725044	329457	3395587	178313	194317	0.92	15411	2301384	34426397	1423660	1.62	1939337	1023153	1.9
Sample-647	4567040	416186	4150854	209157	248648	0.84	60437	3138220	33704915	1428820	2.2	2412960	1263346	1.91
Sample-648	3867101	347027	3520074	185372	203966	0.91	14885	2463107	34508341	1403994	1.75	1984387	1055869	1.88
Sample-649	3892742	338167	3554575	186683	202610	0.92	15146	2494959	34461543	1397783	1.78	1986274	1056998	1.88
Sample-650	3957634	367659	3589975	189653	208856	0.91	20847	2561621	34433032	1396013	1.83	1995801	1067784	1.87
Sample-651	3896444	362053	3534391	188590	205152	0.92	18136	2473650	34494264	1422794	1.74	1969073	1050952	1.87
Sample-652	3937512	353849	3583663	189523	207076	0.92	19745	2538529	34443187	1398983	1.81	2000918	1065659	1.88
Sample-653	3829459	340366	3489093	185278	199034	0.93	13398	2375976	34539676	1453483	1.63	1953105	1041657	1.87
Sample-654	3933942	376176	3557766	190861	208732	0.91	14532	2501792	34479702	1432150	1.75	1965406	1054591	1.86
Sample-655	3947683	374994	3572689	190831	208535	0.92	16101	2562616	34477267	1385067	1.85	1977020	1061318	1.86
